9 12
# # # # # # # # # # # #
# 0 . . # # # # . . . #
# . # . # . # # * # . #
# # # . # . # # # . . #
# . . . # . . . # . # #
# . # # # . # . # . . #
# . . . . . # # # # . #
# # # # # . . . . . . #
# # # # # # # # # # # #