20 16
# # # # # # # # # # # # # # # #
# 0 # . . . * . . . # . . . . #
# . # . # # # # # . # . # # . #
# . . . . . . # # . # . # # . #
# # # # # # . # # . # . # # . #
# # # . . . . # # . # . # # # #
# * # . # # . # . . . . . . . #
# . # . . # . # . # . # # # # #
# . # # # # . # . # . . . # . #
# . . . . # . # . # . # . # . #
# # # # . # . # # # . # . # . #
# . # # . # . . . # . # . # . #
# . # # . # # # # # . # # # . #
# . . . . . . . . . . . . # . #
# # # . # # # # # # # # . # . #
# . . . # . . . . # . . . # . #
# . # # # . # # # # . # # # . #
# . # . # . # # . . . # # . . #
# . . . # . . . . # . . . . # #
# # # # # # # # # # # # # # # #