15 16
# # # # # # # # # # # # # # # #
# * # . . . . . . . # . . . . #
# . # . # # # # # . # . # # . #
# . . . . . . # # . # . # # . #
# # # # # # . # # . # . # # . #
# # # . . . . # # . # . # # # #
# . # . # # . # . . . . . . . #
# . # . . # . # . # . # # # # #
# . # # # # . # . # . . . . . #
# . . . . # . # . # . # . # . #
# # # # . # . # # # . # . # . #
# . # # . # . . . # . # . # . #
# . # # . # # # # # . # # # . #
# . . . . . . . . . . . . # 0 #
# # # # # # # # # # # # # # # #